compelling: convincente
free: libre, gratis
freedom: libertad
unravel: desenmarañar
awaken: despierto
dread: temer
behold: contemplar
beyond: más alla
bind: atar
blind: ciego
breed: criar
dwell: residir
forsee: preveer
kneel: arrodillarse
overtake: pasar
overhear: oír por casualidad
shed: mudar
strive: luchar
tread: pisotear
undergo: someterse
weave: tejer
withstand: resistir
plummet: caer en picado
outweigh: sobrepasar
wax: crecer
enlighten: iluminar
bug: fastidiar
loathe: odiar
flourish: prosperar
wind up: terminar
by the book: según las reglas
fall from grace: caer en desgracia
case in point: buen ejemplo
best of both worlds: lo mejor de cada casa
in a heartbeat: en un santiamén
in the loop: al tanto
draw the line: poner límites
self-steem: autoestima
windfall: beneficio imprevisto
ploy: estrategema
beacon: faro
caveat: advertencia
rule out: descartar
kick in: empezar a hacer efecto
catch on: comprender
cath up: ponerse al día
bear with: aguantar